NO textures/MultibrickD.png
EA textures/wall.png
SO textures/BookshelfL.png
WE textures/TilesL.png


C 25,204,   0



F 23,169,20

111111111111111111111111
111001 100001000000000001
101011101011111110001111
100010100010000010001
111110101111101011101
111111111W1101111111
111111111111111111111111
1
 1                                                                                                   1
1
1
1111111
    11
     111                                     1
                                                                                                                                                                                1
1
1
1
                                                1
                                                    1
111111111111111111111111
     101111101    11111111111
111110001111111111101
101011111010111110101
111111111111111111111
111111111111111111111
10000010101000001
111111101011111011111
100000101000100010001
1011101111101101110111
101000111000100010101
101011111111111010101
100010000000000010001
101010111011111111101
111000001000000000001
111000001000000000001
111000001000000000001
111000001000000000001
111111111111111111111
1
111111111111111111111
