NO textures/MultibrickD.png
EA textures/wall.png
SO textures/BookshelfL.png
WE textures/TilesL.png

C 35,19,73
F 15,6,40

111111111111111111111
101000001 10000000001
101010101 11111110001
100010101 10000010001
111110101 11101011101
100000101 10101000001
101111101 11101111111
101 10001 10100000101
101111111 10111110101
101010001 11100010101
101110101 10101010101
100000101 10001010001
111111101 11111011101
100000101 10100010001
101110101 10101110111
101000101 10100010101
101011111 11111010101
100010001 10000010001
101010111 11111111101
1N1000001 10000000001
111111111111111111111
