







NO no.xpm








SO so.xpm
                        WE we.xpm
        EA ea.xpm            

        F 20,           20,             20
C 200,          200,200

11111
10001
10S01                
10001
10001
10001
11001               
10001
10001
10001
10001
10001
11111           

        





















