        NO mandatory/textures/tex1.png


WE mandatory/textures/tex2.png
SO mandatory/textures/tex3.png
EA mandatory/textures/tex4.png

C 0,0,0
F 50,50,+6
     
     11111      
     10101    
     10001      
     10N01      
     11111