NO ./path_to_the_north_texture.png
WE ./path_to_the_west_texture.png
SO ./path_to_the_south_texture.png
EA ./path_to_the_east_texture.png

F 0,0,3
C 4,4,0







                                                   1111111111111	
                                                  1100000000000011111111111111111111111
                                                  1000000000000000000000000000000000001                                                                        
                                                  1100000000000011111111110111111111101                                                                         
                                                   10000000000001 11111111011111111 101                                                                         
                                111111111111111111110000000000001 10000000000000001 101                                                                                      
                                100000000000000000000011100000001 10111011111111101 101                                                                              
                                10111101111011110101001 100000001 10111011111111101 101  
                                101001010010100101010011100000001 10110000000000001 101                                                                             
                                101001010010100101010000000000001 10000111111011101 101                                                                             
                                101101110011100111010000000000001 10000011111011101 101                                                                         
                                100000000000000000010000000000001 10111000000000001 101                                                                         
                                101111111111111111011110111111111 101 1111110111111 101                                                                         
                                10100000000000000101  1011        101111111101111111101                                                                         
                                11111110101111111111110001        100000000000000000001                                                                         
                                      10101000000000000001        111111111111111111111                                                                        
                                      10101011111111010101                                                                         
                                11111110101010000001010101   1111111                                                                        
                                1010101011110101010111111111110000011                                                                        
                                10000010100101000001   111100000000011                                                                        
                                11111010101101111111111100000000000001                                                                               
                                10001010100001000000000000000000000001                                                                         
                                10111011111101111101111100000000000001                                                                         
                                10000000000000000001   111100000000011                                                                        
                                10111110111111101111      11110000011                                                                        
                          111   101  1101111 1101            1111111                                                                                   
                          10111110111111100111111                                                                               
                          1000000001   1100001                                                                                    
                          1011110001111100101111111                                                                              
              1111111111  111  11000000000000000001                                                                                    
              1000000001        1111110W01111111111                                               
              1011111111             11011                                      11111                        
              101               11111110111111111111111                         10001                                       
              101               10000000000000000000001                         10001                                    
              10111111111111111110100000000000000000101                         10001                
              10000000000000000000000000000000000000001                         11111                                    
              10111111111111111110000000000000000000001                                                                         
              101               10000000111000000000001                                                                         
              101               100000001 1000000000001                                                                         
              101               10000000111000000000001                                                                         
              10111111111111111110000000000000000000001                                                                         
              100000000000000000000000000000000000000011111                                                                        
              111111111111111111010000000000000000000000001                                                                        
                               1100000000000000000000011101                                                                         
                                11101111111111111111011 101                                                                         
                                 110111111111111   11111101111111111                                                                             
                                 10000000000000111111100000000000001                                                                                 
                                 10000000000000000000000000000000001                                                                         
                                 10000000000000111111100000000000001                                                                         
                                 100000000000001     100000000000001                                                                         
                                 111111111111111     1111111111111111111                                                                         
                                                                    11111111                                                                               







																	