NO ./path_to_the_north_texture
WE ./path_to_the_west_texture        
SO ./path_to_the_south_texture
EA ./path_to_the_east_texture

F 0,0,0
C 4,4,7

         
        111111111111111111   
       1000000000000000011
       11100000000000000001    
      100000001010000001111
      1111100000001010000001
     1000000011100000011111
     11111100000000000000001
    1000000000000000011111111      
    11111011100000E00000000001
   10001101111100000111101111
    111000000110001100000000011
    111000000110001100000000011
   10001111111100000111101111      
    11111111100000100000000001
    1000000000000000011111111      
     11111100000000000000001
     1000000011100000011111     
      1111100000001010000001
      100000001010000001111
       11100000000000000001                                   
       1000000000000000011
        111111111111111111    






