NO ./path_to_the_north_texture
WE ./path_to_the_west_texture        
SO ./path_to_the_south_texture
EA ./path_to_the_east_texture

F 0,0,0
C 4,4,7

         
  1111111111111111111111111   
  1001100000000000000000011
  1001111000000000000000001
  1001000000000101000000111
  1001111100000000010100001
  1000000000001110000001111
  1001111100000000000000001
  1000000000000000000011111
  11111101110000000000000E1
  1000110111001100000111101
  1001000000001100011000001
  1001000000001100011000001
  1000111111001100000111101
  1001111111000000010000001
  1000000000000000000011111
  1001111100000000000000001
  1000000000001110000001111
  1001111100000000010100001
  1001000000000101000000111
  1111111111111111111111111   

