NO ./path_to_the_north_texture.png
WE ./path_to_the_west_texture.png
SO ./path_to_the_south_texture.png
EA ./path_to_the_east_texture.png

C 0,0,0
F 50,50,50

         
  111111111111   
  100000000001
  100011100001
  100100000001
  100011110001
  100000000001
  100111110001
  100000000001
  100000000001
  100000000001
  100000000001
  100000000001
  100000000001
  100000000001
  100010000001
  100000000001
  100000000001
  100000000001
  1000N1011101
   1111 11  1 