NO ./path_to_the_north_texture
WE ./path_to_the_west_texture        
SO ./path_to_the_south_texture
EA ./path_to_the_east_texture

F 0,0,0
C 4,4,7

         
  111111111111   
  100000000001
  100011100001
  100100000001
  100011110001
  100000000001
  100111110001
  100000000001
  1000N1011101
   1111 11  1 