.cub flekhr













    
                                 111111111111           
                                10000000000001111111111111111111111
                                100000000000000000000000000000000001
                                100000000000011111111110111111111101
                                10000000000001  111111101111111  101
              11111111111111111110000000000001 10000000000000001 101             
             100000000000000000000000000000001 10111011111111101 101     
             101111011110111101010000000000001 10111011111111101 101
             101001010010100101010000000000001 10110000000000001 101    
             101001010010100101010000000000001 10000111111011101 101    
             101101110011100111010000000000001 10000111111011101 101
             100000000000000000010000000000001 10110000000000001 101
             10111111111111111101111011111111  101 111111011111  101
             10100000000000000101  101         101111111101111111101
              1 11110101111111111110001        100000000000000000001
                   10101000000000000001         1111111111111111111
                   10101011111111010101
              1 1 110101010000001010101      11111
             10101010111101010101        1111000001
             10000010100101000001    11110000000001
             11111010101101111111111100000000000001      
             10001010100001000000000000000000000001
             10111011111101111101111100000000000001
             10000000000000000001    11110000000001
             1011111011111110111         1111000001
        1    10111110111111101               11111           
       1011111011111110011           
       1011111011111100001           
       101111000111110110111111      
        1    1000000W00000000001           
             111111000111111111           
                  11011
              111111011111111111111
             10000000000000000000001
             10100000000000000000101
             10000000000000000000001
             10000000000000000000001
             10000000111000000000001
             100000001 1000000000001
             10000000111000000000001
             10000000000000000000001
             10000000000000000000001111
             101000000000000000000000001
             100000000000000000000011101
              110111111111111111101  101
               1011111111111     1 1110111111111     
              10000000000000111111100000000000001        
              10000000000000000000000000000000001
              10000000000000111111100000000000001
              100000000000001     100000000000001
               1111111111111       111111111111111111
                                                 11111111      
                    
                               
                        
                                
                                