		NO ./path_to_the_north_texture
WE ./path_to_the_west_texture        
SO ./path_to_the_south_texture
EA ./path_to_the_east_texture

F     2,8,5
C 225,30,0

                    111111111111
                   10000000000001
                   10000000000001
                   10000000000001
                   10000000000001
 11111111111111111110000000000001
100000000000000000000000000000001
101111011110111101010000000000001
101001010010100101010000000000001
101001010010100101010000000000001
101101110011100111010000000000001
100000000000000000010000000000001
10111111111111111101111111111111
10100000000000000101
10101111111111110101
10101000000000010101
10101011111111010101
10101010000001010101            11111
10101010111101010101        1111000001
10000010100101000001    11110000000001
11111010101101111111111100000000000001
10001010100001000000000000000000000001
10111011111101111101111100000000000001
10000000000000000001    11110000000001
1011111011111110111         1111000001
10111110111111101               11111
1011111011111110011
1011111011111100001
1011110001111101101
1000000W00000000001
111111000111111111
     11011
 111111011111111111111
10000000000000000000001
10100000000000000000101
10000000000000000000001
10000000000000000000001
10000000000000000000001
10000000000000000000001
10000000000000000000001
10000000000000000000001
10000000000000000000001
10100000000000000000101
10000000000000000000001
 111111111111111111111