NO textures/MultibrickD.png
EA textures/wall.png
SO textures/BookshelfL.png
WE textures/TilesL.png

F      17,    38,     64



C 218, 234, 235

1111111111111111111111111
1N00110000100000000000001
1000110000000000111111001
1000110000000000110001001
1000000000100000100001001
1111111111111111111111111
