NO mandatory/textures/tex4.png
SO mandatory/textures/tex5.png
EA mandatory/textures/tex3.png
WE mandatory/textures/tex2.png

F 74, 4, 4
C 0, 0, 0


111111111111   
111111111111
100011100001
100100000001
100011110001
100000000001
100111110001
100000000001
100000000001
100000000001
100000000001
100000000001
1000000000011111111
10000N00000D00000001
1000100000011111111
100000000001
100000000001
100000000001
100001011101
 1111 11  1 


   